#########################
#.......................#
#.......................#
#.......................#
#.......................#
#.......................#
#.......................#
#......#...#............#
#......#...#............#
#......#...#............#
#......#####............#
w..........#............#
#..........#............#
#..........#............#
#..........#............#
#.......................#
#.......................#
#.......................#
#.......................#
#.......................#
#.......................#
#.......................#
#.......................#
#.......................#
#########################
